NO ./bricksx64_NORTH.png
SO ./bricksx64_SOUTH.png
WE ./bricksx64_OUEST.png
EA ./bricksx64_EST.png


C 80,90,120
F 200,200,200


1111111111111111111111111111111111111111111111111111111111111111111111111
1000000000000000000000000000000001000000000000100000000000010000000000001
100N000000000000000000000000000002000000000000100000000000010000000000011
1000000000000000000000000000000001000000000000100000000000010000000000001
1000000000000000000000000000000001000000000000200000000000010000000000001
1000000000000000000000000000000001000000000000100000000000010000000000001
1000000000000000000000000000000001000000000000100000000000020000000000001
1111111111111111111111111111111111111111111111111111111111111111111111111
